# #####################################
#              ########################
# #### ####### #####         ##########
# #### ######        ### ### ##########
# #### ######### ### ### ### ##########
# #### ######### ### ### ###       ####
#            ####### ### ### ##### ####
#### #######     ### ### ### ##### ####
#### ####### ####### ### ### ##### ####
#### ####### ####### ### ###       ####
#### #######         ### ### ##########
####     ##### ######### ### ##########
##############     ##### ###      #####
##################       ########       
#######################################
