# #####################################
#        ######    ########      ######
######## ###### ## ##       #### ######
######## ###### ##    ##### #### ######
##       ###### ########### #### ######
## ##### ###       ########  ### ######
## ##### ### ##### ###       ### ######
##   ### ### ##### ### ##### ### ######
## ##### ### ##### ### #####     ######
## ##### ### #####     ###### ## ######
## ##### ### ########         ## ######
## #####     ################### ######
##   ##### ##################### ######
####       #####################        
#######################################