# #####################################
# #### ####                        ####
#        ## ## ################### ####
# ###### ## ## ##      ########### ####
# ### ## ## ## ## #### ########### ####
# ### ## ## ## ## #### ########### ####
# ### ## ## ##    ####        #### ####
# ### ## ## ########## ###### #### ####
# ### ##        ###### ###### #### ####
# ### ######### ###### ###### #### ####
#     ## ###### ##     ### ####### ####
########        ## ####### #       ####
################## ####### ############
##################                      
#######################################